6 6
1 1
6 6
1 1 X 2 3 1
2 1 X 2 3 3
1 1 X 1 3 3
2 2 2 1 3 5
1 1 1 X 1 7
4 1 1 1 1 9